##########################
###@*******#############`#
###*****D****************#
######*****x******########
######*********x****######
######***x********########
#################&########