##########################
#######***x*************@#
######****x****D********##
###******#################
####***x****##############
######****x**************&
##########################