##########################
#@***********************#
#*#######*********D******#
#*****#######**********###
#**D**#######****x*****###
#****x#######**********###
######################&###