#&########################
#***********######******@#
#*****x*****######*******#
#*******D***####****######
######******######**######
####****x******x*****#####
##########################