##########################
#x***D******@***********x#
######*************#######
###********####**********#
###****x***#####****x****#
###********#####*********#
###&####################&#