##########################
##********#########@######
##****x****###***********#
##********x*******x****###
###***x***D***x*******####
#####****x********&#######
##########################