@@@@@@@@@@@@@@@@@@@@@@@@@@@@@@@@@@@@@@@@@@@@@@@@@@@@@@@@@@@@@@@@@@@@@@@@@@@@
@@@@@@@@@@@@@@@@@@@@@@@@@@@@@@@@@@@@@@@@@@@@@@@@@@@@@@@@@@@@@@@@@@@@@@@@@@@@
@@@@%:=+++--@@@@@@@@@@@@@@@@@@@@@@@@@@@@@@@@@@@@@@@@@@@@@@@@@@@@@@@@@@@@@@@@
@@@@@+-=+++=:-@@@@@@@@@@@@@@@@@@@@@@@@@@@@@@@@@@@@@@@@@@@@@@@@@@@@@@@@@@@@@@
@@@@@@-:-+++==@@@@@@@@@@@@@@@@@@@@@@@@@@@@@@@@@@@@@@@@@@@@@@@@@@@@@@@@@@@@@@
@@@@@%.::++++=@@@@@@@@@@@@@@@@@@@@@@@@@@@@@@@@@@@@@@@@@@@@@@@@@@@@@@@@@@@@@@
@@@@@%.:-=++-%@@@@@@@@@@@@@@@@@@@@@@@@@@@@@@@@@@@@@@@@@@@@@@@@@@@@@@@@@@@@@@
@@@@@@--=+++-@@@@@@@@@@@@@@@@@@@@@@@@@@@@@@@@@@@@@@@@@@@@@@@@@@@@@@@@@@@@@@@
@@@@@@+-+++==@@@@@@@@@@@@@@@@@@@@@@@@@@@@@@@@@@@@@@@@@@@@@@@@@@@@@@@@@@@@@@@
@@@@@@*-++++--#@@@@@@@@@@@@@@@@@@@@@@@@@@@@@@@@@@@@@@@@@@@@@@@@@@@@@@@@@@@@@
@@@@@@#+++++++==@@@@@@@@@@@@@@@@@@@@@@@@@@@@@@@@%#@%**#####@@@@@@@@@@@@@@@@@
@@@@@@%=+++++++=*@@@@@@@@@@@@@@@@@@@@@@@@@@@@@@-#=@#-#%@@@@@**@@@@@@@@@@@@@@
@@@@@@#+++++++++=@@@@@@@@@@@@@@@@@@@@@@@@@@@@@=*%*@@@@#%@@@@@@@+%==@@@@@@@@@
@@@@@%=+++++++++#@@@@@@@@@@@@@@@@@@@@@@@@@@+*:+%%@@@@@@@@@@@@@@*+*%#@@@@@@@@
@@@@@@=++++++++=%@@@@@@@@@@@@@@@@@@@@@@++#*#%%%@@@@@@@@@@@@@@%+**%%-+%@@@@@@
@@@@@@%=++++++=@@@@@@@@@@@@@@@@@@@@@@@+*%-*@:*@#%@@%%%%%%%%%@@@@@@@%:+@@@@@@
@@@@@@*+++++=@@@@@@@@@@@@@@@@@@@@@@@@@=*=@@@.*%###%@@@@:#@@#%@@@@@@@@*@@@@@@
@@@@@%=++++:*@@@@@@@@@@@@@@@@@@@@@@#=%#-=#####%@%#@@@@%.*@@##@@@@@@@@#@@@@@@
@@@@%=++++=:@@@@@@@@@@@@@@@@@@@@@#:*#@@@@@@@@@@@@##@@@@@@@#%@@@@@@@@@%@@@@@@
@@@@#++****@@@@@@@@@@@@@@@@@@@@@@=%*@=@@@@+#@@@@@@@@@@@@@@@@%@@@@@@@@#@@@@@@
@@@@+******-##%***##**@@@@@@@@@@@%--@@@@@@@@@@@@@@@@@@@@@@@@:%@@@@@@@#@@@@@@
@@@@@*++==++*@@@@@@@@@@@@@@@@@%*****+++=*%%@@@@@@@@@@@@@@@@#-@@@@@@@*%@@@@@@
@@@@@@@=-==-@@@@@@@@@@@@@@@@@@@@@@@@@@@@@%#:***+--+*%@@@@%=#@@@@@@@*%@@@@@@@
@@@@@@@@#+=****%#*****---------:::.:=---:%@@@@@@@@@@@@@@@+%@@@@@@@#%@@@@@@@@
@@@@@@@@@@@@@@@@@@@@@@@@@@@@@@::...-=-----:+**#@@%****-:.#@@@@@@@@*%@@@@@@@@
@@@@@@@@@@@@@@@@@@@@@@@@@@@@@@*:..-#####=---------------::@@@@@@@@*%@@@@@@@@
@@@@@@@@@@@@@@@@@@@@@@@@@@@@@@@-.:##......-=:..++--==:.....:-#@@*=#@@@@@@@@@
@@@@@@@@@@@@@@@@@@@@@@@@@@@@@@@#-+##.............#*-...........:-@@@@@@@@@@@
@@@@@@@@@@@@@@@@@@@@@@@@@@@@@@@@#*##............:###=-..........:=@@@@@@@@@@
@@@@@@@@@@@@@@@@@@@@@@@@@@@@@@@%:####-.........*####*===.........-=@@@@@@@@@
@@@@@@@@@@@@@@@@@@@@@@@@@@@@@@@:=#####+.....-#######*===:........--%@@@@@@@@
@@@@@@@@@@@@@@@@@@@@@@@@@@@@@@*-########++###########=..........-=@@@@@@@@@@
@@@@@@@@@@@@@@@@@@@@@@@@@@@@@@@-####################*=::......:=%*@@@@@@@@@@
@@@@@@@@@@@@@@@@@@@@@@@@@@@@@@@-*###################=:@@@@@@@%*#*@=%@@@@@@@@
@@@@@@@@@@@@@@@@@@@@@@@@@@@@@@@+-=*#################*:@@@@@@=.::+=@@@@@@@@@@
@@@@@@@@@@@@@@@@@@@@@@@@@@@@@-=##%%*+*###############=-%+--.%-+--+=%@@@@@@@@
@@@@@@@@@@@@@@@@@@@@@@@@@@@@@+=#@@@@@@@#*+*############+-:=+*######+@@@@@@@@
@@@@@@@@@@@@@@@@@@@@@@@@@@@@@@#==-=%@@@@*=+@@*=-=****######****--*@@@@@@@@@@
@@@@@@@@@@@@@@@@@@@@@@@@@@@@@@@@@@@#####%@@@@@@@+=#**%%#%###@=:@@@@@@@@@@@@@
@@@@@@@@@@@@@@@@@@@@@@@@@@@@@@@@@@@@@@@@@@@@@@@@+=@@@@@@@@@@@#==#@@@@@@@@@@@
@@@@@@@@@@@@@@@@@@@@@@@@@@@@@@@@@@@@@@@@@@@@@@@@+-*@@@@#*@@@%==-+@@@@@@@@@@@
@@@@@@@@@@@@@@@@@@@@@@@@@@@@@@@@@@@@@@@@@@@@@@@@@@@**##+--***+*@@@@@@@@@@@@@
@@@@@@@@@@@@@@@@@@@@@@@@@@@@@@@@@@@@@@@@@@@@@@@@@@@@@@@@@@@@@@@@@@@@@@@@@@@@
@@@@@@@@@@@@@@@@@@@@@@@@@@@@@@@@@@@@@@@@@@@@@@@@@@@@@@@@@@@@@@@@@@@@@@@@@@@@