##################################################################################
##########################++#####################################################+
########################+++########+----------+################################+++
#######################+###########-...........################################+##
################################..................+###############################
###############################+..................-###############################
###############################+..-............+..+#####################+#########
#################################+.............-+#################################
#####################################+.....--#####################################
#######################################....#######################################
##########################+##########+-......##################+#################+
#####################################+------+#####################################
##################################################################################
##################################################################################
####################################+++###########################################
################..###...##....##.-+...+##+.###...#...+.+##+..+...#################
################..##....-.##...+..#-..+##+.###...+...+...++..-...#################
#################......#-.##...+.-#-..+##+.+.-...+...+.-#....-...#################
##########+#######...+##-.##...+.-#-..+##+.+.....+...+.-##+..-+---################
#######++#########-..+####....###....######.-...##...+.+###..-...#################
#####+++####################################################+++###################
##################################################################################
##################################################################################
##################################################################################
##################################################################################